111111
100101
101001
1100P1
111111
111111